"aa" = (/turf/icon/white,/area/debug)
"ab" = (/turf/icon/white/blue,/area/debug)
"ac" = (/turf/icon/white/blue/corner,/area/debug)
"ad" = (/turf/icon/white/blue/corner{tag = "icon-whitebluecorner (EAST)"; icon_state = "whitebluecorner"; dir = 4},/area/debug)
"ae" = (/turf/icon/white/blue/corner{tag = "icon-whitebluecorner (NORTH)"; icon_state = "whitebluecorner"; dir = 1},/area/debug)
"af" = (/turf/icon/white/blue/corner{tag = "icon-whitebluecorner (WEST)"; icon_state = "whitebluecorner"; dir = 8},/area/debug)
"ag" = (/turf/icon/white/blue/full,/area/debug)
"ah" = (/turf/icon/plating,/area/debug)
"ai" = (/turf/icon/white/bot,/area/debug)
"aj" = (/turf/icon/white/green,/area/debug)
"ak" = (/turf/icon/white/green/corner,/area/debug)
"al" = (/turf/icon/white/green/corner{tag = "icon-whitegreencorner (EAST)"; icon_state = "whitegreencorner"; dir = 4},/area/debug)
"am" = (/turf/icon/white/green/corner{tag = "icon-whitegreencorner (NORTH)"; icon_state = "whitegreencorner"; dir = 1},/area/debug)
"an" = (/turf/icon/white/green/corner{tag = "icon-whitegreencorner (WEST)"; icon_state = "whitegreencorner"; dir = 8},/area/debug)
"ao" = (/turf/icon/white/green/full,/area/debug)
"ap" = (/turf/spess,/area/debug)
"aq" = (/turf/wall/bananium{density = 0; opacity = 0},/area/debug)
"ar" = (/turf/wall/iron{density = 0; opacity = 0},/area/debug)
"as" = (/turf,/area/debug)
"at" = (/turf/wall/sandstone{density = 0; opacity = 0},/area/debug)
"au" = (/turf/wall/uranium{density = 0; opacity = 0},/area/debug)
"av" = (/turf/icon/white/delivery,/area/debug)
"aw" = (/turf/icon/white/purple,/area/debug)
"ax" = (/turf/icon/white/purple/corner,/area/debug)
"ay" = (/turf/icon/white/purple/corner{tag = "icon-whitepurplecorner (EAST)"; icon_state = "whitepurplecorner"; dir = 4},/area/debug)
"az" = (/turf/icon/white/purple/corner{tag = "icon-whitepurplecorner (NORTH)"; icon_state = "whitepurplecorner"; dir = 1},/area/debug)
"aA" = (/turf/icon/white/purple/corner{tag = "icon-whitepurplecorner (WEST)"; icon_state = "whitepurplecorner"; dir = 8},/area/debug)
"aB" = (/turf/icon/white/purple/full,/area/debug)
"aC" = (/turf/icon/white/red,/area/debug)
"aD" = (/turf/icon/white/red/corner,/area/debug)
"aE" = (/turf/icon/white/red/corner{tag = "icon-whiteredcorner (EAST)"; icon_state = "whiteredcorner"; dir = 4},/area/debug)
"aF" = (/turf/icon/white/red/corner{tag = "icon-whiteredcorner (NORTH)"; icon_state = "whiteredcorner"; dir = 1},/area/debug)
"aG" = (/turf/icon/white/red/corner{tag = "icon-whiteredcorner (WEST)"; icon_state = "whiteredcorner"; dir = 8},/area/debug)
"aH" = (/turf/icon/white/red/full,/area/debug)
"aI" = (/turf/icon/white/yellow,/area/debug)
"aJ" = (/turf/icon/white/yellow/corner,/area/debug)
"aK" = (/turf/icon/white/yellow/corner{tag = "icon-whiteyellowcorner (EAST)"; icon_state = "whiteyellowcorner"; dir = 4},/area/debug)
"aL" = (/turf/icon/white/yellow/corner{tag = "icon-whiteyellowcorner (NORTH)"; icon_state = "whiteyellowcorner"; dir = 1},/area/debug)
"aM" = (/turf/icon/white/yellow/corner{tag = "icon-whiteyellowcorner (WEST)"; icon_state = "whiteyellowcorner"; dir = 8},/area/debug)
"aN" = (/turf/icon/white/yellow/full,/area/debug)
"aO" = (/turf/icon/blue/full,/area/debug)
"aP" = (/turf/icon/blue,/area/debug)
"aQ" = (/turf/icon/blue{tag = "icon-blue (EAST)"; icon_state = "blue"; dir = 4},/area/debug)
"aR" = (/turf/icon/blue{tag = "icon-blue (NORTH)"; icon_state = "blue"; dir = 1},/area/debug)
"aS" = (/turf/icon/blue{tag = "icon-blue (NORTHEAST)"; icon_state = "blue"; dir = 5},/area/debug)
"aT" = (/turf/icon/blue{tag = "icon-blue (NORTHWEST)"; icon_state = "blue"; dir = 9},/area/debug)
"aU" = (/turf/icon/blue{tag = "icon-blue (SOUTHEAST)"; icon_state = "blue"; dir = 6},/area/debug)
"aV" = (/turf/icon/blue{tag = "icon-blue (SOUTHWEST)"; icon_state = "blue"; dir = 10},/area/debug)
"aW" = (/turf/icon/blue{tag = "icon-blue (WEST)"; icon_state = "blue"; dir = 8},/area/debug)
"aX" = (/turf/icon/blue/corner,/area/debug)
"aY" = (/turf/icon/blue/corner{tag = "icon-bluecorner (EAST)"; icon_state = "bluecorner"; dir = 4},/area/debug)
"aZ" = (/turf/icon/blue/corner{tag = "icon-bluecorner (NORTH)"; icon_state = "bluecorner"; dir = 1},/area/debug)
"ba" = (/turf/icon/blue/corner{tag = "icon-bluecorner (WEST)"; icon_state = "bluecorner"; dir = 8},/area/debug)
"bb" = (/turf/icon/blue/red,/area/debug)
"bc" = (/turf/icon/blue/red{tag = "icon-bluered (EAST)"; icon_state = "bluered"; dir = 4},/area/debug)
"bd" = (/turf/icon/blue/red{tag = "icon-bluered (NORTH)"; icon_state = "bluered"; dir = 1},/area/debug)
"be" = (/turf/icon/blue/red{tag = "icon-bluered (NORTHEAST)"; icon_state = "bluered"; dir = 5},/area/debug)
"bf" = (/turf/icon/blue/red{tag = "icon-bluered (NORTHWEST)"; icon_state = "bluered"; dir = 9},/area/debug)
"bg" = (/turf/icon/blue/red{tag = "icon-bluered (SOUTHEAST)"; icon_state = "bluered"; dir = 6},/area/debug)
"bh" = (/turf/icon/blue/red{tag = "icon-bluered (SOUTHWEST)"; icon_state = "bluered"; dir = 10},/area/debug)
"bi" = (/turf/icon/blue/red{tag = "icon-bluered (WEST)"; icon_state = "bluered"; dir = 8},/area/debug)
"bj" = (/turf/wall/cult{density = 0; opacity = 0},/area/debug)
"bk" = (/turf/wall/plasma{density = 0; opacity = 0},/area/debug)
"bl" = (/turf/wall/silver{density = 0; opacity = 0},/area/debug)
"bm" = (/turf/wall/wood{density = 0; opacity = 0},/area/debug)
"bn" = (/turf/icon/blue/yellow,/area/debug)
"bo" = (/turf/icon/blue/yellow{tag = "icon-blueyellow (EAST)"; icon_state = "blueyellow"; dir = 4},/area/debug)
"bp" = (/turf/icon/blue/yellow{tag = "icon-blueyellow (NORTH)"; icon_state = "blueyellow"; dir = 1},/area/debug)
"bq" = (/turf/icon/blue/yellow{tag = "icon-blueyellow (NORTHEAST)"; icon_state = "blueyellow"; dir = 5},/area/debug)
"br" = (/turf/icon/blue/yellow{tag = "icon-blueyellow (NORTHWEST)"; icon_state = "blueyellow"; dir = 9},/area/debug)
"bs" = (/turf/icon/blue/yellow{tag = "icon-blueyellow (SOUTHEAST)"; icon_state = "blueyellow"; dir = 6},/area/debug)
"bt" = (/turf/icon/blue/yellow{tag = "icon-blueyellow (SOUTHWEST)"; icon_state = "blueyellow"; dir = 10},/area/debug)
"bu" = (/turf/icon/blue/yellow{tag = "icon-blueyellow (WEST)"; icon_state = "blueyellow"; dir = 8},/area/debug)
"bv" = (/turf/wood,/area/debug)
"bw" = (/turf/wood/broken/rand,/area/debug)
"bx" = (/turf/wood/broken/states/s1,/area/debug)
"by" = (/turf/wood/broken/states/s2,/area/debug)
"bz" = (/turf/wood/broken/states/s3,/area/debug)
"bA" = (/turf/wood/broken/states/s4,/area/debug)
"bB" = (/turf/wood/broken/states/s5,/area/debug)
"bC" = (/turf/wood/broken/states/s6,/area/debug)
"bD" = (/turf/wood/broken/states/s7,/area/debug)
"bE" = (/turf/wood/missing,/area/debug)
"bF" = (/turf/icon/plating,/turf/wood/missing,/area/debug)
"bG" = (/turf/icon/asteroid,/area/debug)
"bH" = (/turf/icon/asteroid/rand,/area/debug)
"bI" = (/turf/wall/diamond{density = 0; opacity = 0},/area/debug)
"bJ" = (/turf/wall{density = 0; opacity = 0},/area/debug)
"bK" = (/turf/wall/reinforced{density = 0; opacity = 0},/area/debug)
"bL" = (/turf/icon/carpet,/area/debug)
"bM" = (/turf/icon/asteroid/states/s1,/area/debug)
"bN" = (/turf/icon/asteroid/states/s2,/area/debug)
"bO" = (/turf/icon/asteroid/states/s3,/area/debug)
"bP" = (/turf/icon/asteroid/states/s4,/area/debug)
"bQ" = (/turf/icon/asteroid/states/s5,/area/debug)
"bR" = (/turf/icon/asteroid/states/s6,/area/debug)
"bS" = (/turf/icon/asteroid/states/s7,/area/debug)
"bT" = (/turf/icon/asteroid/states/s8,/area/debug)
"bU" = (/turf/icon/asteroid/states/s9,/area/debug)
"bV" = (/turf/icon/asteroid/states/s10,/area/debug)
"bW" = (/turf/icon/asteroid/states/s11,/area/debug)
"bX" = (/turf/icon/plating/dmg/states/s1,/area/debug)
"bY" = (/turf/icon/plating/dmg/states/s2,/area/debug)
"bZ" = (/turf/icon/plating/dmg/states/s3,/area/debug)
"ca" = (/turf/wall/gold{density = 0; opacity = 0},/area/debug)
"cb" = (/turf/wall/rusty{density = 0; opacity = 0},/area/debug)
"cc" = (/turf/wall/rusty/reinforced{density = 0; opacity = 0},/area/debug)
"cd" = (/turf/wall/abductor{density = 0; opacity = 0},/area/debug)
"ce" = (/turf,/area/debug/lit)
"cf" = (/obj/light/street_post,/turf,/area/debug/lit)
"cg" = (/obj/light,/turf,/area/debug/lit)
"ch" = (/obj/structure/rack,/turf,/area/debug)
"ci" = (/obj/landmark/start,/turf,/area/debug)
"cj" = (/obj/item/debugger,/turf,/area/debug)
"ck" = (/obj/structure/rack/special,/turf,/area/debug)
"cl" = (/obj/item/clothing/uniform/chameleon,/obj/item/storage/bag,/turf,/area/debug)
"cm" = (/turf/wall,/area/debug)
"cn" = (/mob/living,/turf,/area/debug)
"co" = (/obj/item/lighter,/turf,/area/debug)
"cp" = (/obj/structure/mirror,/turf,/area/debug)
"cq" = (/obj/item/radio/transmitter,/turf,/area/debug)
"cr" = (/obj/structure/radio_reciever,/turf,/area/debug)
"cs" = (/obj/structure/window/opaque,/turf,/area/debug)

(1,1,1) = {"
aaabacadaeafagahahahahahahahahahahahahahahahahahahahahahahahahahahahahahahahahahahahahahahahahahahah
aiajakalamanaoahapapapapapahaqahahaqahaqahaharasasarasarasahatahahatahatahahauahahauahauahahahahahah
avawaxayazaAaBahapapapapapahahahahaqahahaqahasasasarasasarahahahahatahahatahahahahauahahauahahahahah
ahaCaDaEaFaGaHahapapapapapahaqaqahahahahahahararasasasasasahatatahahahahahahauauahahahahahahahahahah
ahaIaJaKaLaMaNahapapapapapahahahahaqaqaqahahasasasarararasahahahahatatatahahahahahauauauahahahahahah
ahahahahahahahahahahahahahahaqaqahaqaqaqahahararasarararasahatatahatatatahahauauahauauauahahahahahah
aOaPaQaRaSaTaUaVaWahahahahahaqaqahaqaqaqahahararasarararasahatatahatatatahahauauahauauauahahahahahah
ahaXaYaZbaasasasasahahahahahahahahahahahahahahahahahahahahahahahahahahahahahahahahahahahahahahahahah
ahbbbcbdbebfbgbhbiahahahahahbjasasbjasbjasahbkahahbkahbkahahblahahblahblahahbmahahbmahbmahahahahahah
ahbnbobpbqbrbsbtbuahahahahahasasasbjasasbjahahahahbkahahbkahahahahblahahblahahahahbmahahbmahahahahah
ahahahahahahahahahahahahahahbjbjasasasasasahbkbkahahahahahahblblahahahahahahbmbmahahahahahahahahahah
bvbwahahahahahahahahahahahahasasasbjbjbjasahahahahbkbkbkahahahahahblblblahahahahahbmbmbmahahahahahah
ahbxbybzbAbBbCbDahahahahahahbjbjasbjbjbjasahbkbkahbkbkbkahahblblahblblblahahbmbmahbmbmbmahahahahahah
ahbEbFahahahahahahahahahahahbjbjasbjbjbjasahbkbkahbkbkbkahahblblahblblblahahbmbmahbmbmbmahahahahahah
ahahahahahahahahahahahahahahahahahahahahahahahahahahahahahahahahahahahahahahahahahahahahahahahahahah
bGbHahahahahahahahahahahahahbIahahbIahbIahahbJasasbJasbJasahbKasasbKasbKasahbLahahbLahbLahahahahahah
ahbMbNbObPbQbRbSbTbUbVbWahahahahahbIahahbIahasasasbJasasbJahasasasbKasasbKahahahahbLahahbLahahahahah
asasasasasahahahahahahahahahbIbIahahahahahahbJbJasasasasasahbKbKasasasasasahbLbLahahahahahahahahahah
ahbXbYbZasahahahahahahahahahahahahbIbIbIahahasasasbJbJbJasahasasasbKbKbKasahahahahbLbLbLahahahahahah
asasasasasahahahahahahahahahbIbIahbIbIbIahahbJbJasbJbJbJasahbKbKasbKbKbKasahbLbLahbLbLbLahahahahahah
ahahahahahahahahahahahahahahbIbIahbIbIbIahahbJbJasbJbJbJasahbKbKasbKbKbKasahbLbLahbLbLbLahahahahahah
ahahahahahahahahahahahahahahahahahahahahahahahahahahahahahahahahahahahahahahahahahahahahahahahbJbKah
ahahahahahahahahahahahahahahcaahahcaahcaahahcbahahcbahcbahahccahahccahccahahcdahahcdahcdahahahbJbKah
ahahahahahahahahahahahahahahahahahcaahahcaahahahahcbahahcbahahahahccahahccahahahahcdahahcdahahahahah
ahahahahahahahahahahahahahahcacaahahahahahahcbcbahahahahahahccccahahahahahahcdcdahahahahahahahcbccah
ahahahahahahahahahahahahahahahahahcacacaahahahahahcbcbcbahahahahahccccccahahahahahcdcdcdahahahcbccah
ahahahahahahahahahahahahahahcacaahcacacaahahcbcbahcbcbcbahahccccahccccccahahcdcdahcdcdcdahahahahahah
ahahahahahahahahahahahahahahcacaahcacacaahahcbcbahcbcbcbahahccccahccccccahahcdcdahcdcdcdahahahahahah
asasasasasasasasasasasasasasasasasasasasasasasasasasasasasasasasasasasasasasasasasasasasasasasasasas
asasasasasasasasasasasasasasasasasasasasasasasasasasasasasasasasasasasasasasasasasasasasasasasasasas
cececececececececececececececececececeasasasasasasasasasasasasasasasasasasasasasasasasasasasasasasas
cececececececececececececececececececeasasasasasasasasasasasasasasasasasasasasasasasasasasasasasasas
cececececececececececececececececececeasasasasasasasasasasasasasasasasasasasasasasasasasasasasasasas
cececececececececececececececececececeasasasasasasasasasasasasasasasasasasasasasasasasasasasasasasas
cecececececfcecececececececececgcececeasasasasasasasasasasasasasasasasasasasasasasasasasasasasasasas
cececececececececececececececececececeasasasasasasasasasasasasasascsasasasasasasasasasasasasasasasas
cececececececececececececececececececeasasasasasasasasasasasasasasasasasasasasasasasasasasasasasasas
cececececececececececececececececececeasasasasasasasasasasasasasasasasasasasasasasasasasasasasasasas
cececececececececececececececececececeasasasasasasasasasasasasasasasasasasasasasasasasasasasasasasas
asasasasasasasasasasasasasasasasasasasasasasasasasasasasasasasasasasasasasasasasasasasasasasasasasas
asasasasasascrasasasasasasasasasasasasasasasasasasasasasasasasasasasasasasasasasasasasasasasasasasas
ascpcpasaschcicjasasasasasasasasasasasasasasasasasasasasasasasasasasasasasasasasasasasasasasasasasas
asasasasasckasclasasasasasascmasasasasasasasasasasasasasasasasasasasasasasasasasasasasasasasasasasas
asasasasascnascoasasasasasascmasasasasasasasasasasasasasasasasasasasasasasasasasasasasasasasasasasas
asasasasasascqasasasasasasascmasasasasasasasasasasasasasasasasasasasasasasasasasasasasasasasasasasas
asasasasasasasasasasasasasasasasasasasasasasasasasasasasasasasasasasasasasasasasasasasasasasasasasas
asasasasasasasasasasasasasasasasasasasasasasasasasasasasasasasasasasasasasasasasasasasasasasasasasas
asasasasasasasasasasasasasasasasasasasasasasasasasasasasasasasasasasasasasasasasasasasasasasasasasas
asasasasasasasasasasasasasasasasasasasasasasasasasasasasasasasasasasasasasasasasasasasasasasasasasas
asasasasasasasasasasasasasasasasasasasasasasasasasasasasasasasasasasasasasasasasasasasasasasasasasas
"}
