"a" = (/turf/white,/area)

(1,1,1) = {"
aa
aa
"}
