"a" = (/turf/white,/area)
"b" = (/turf/black,/area)

(1,1,1) = {"
aab
abb
"}
